#OTU ID	KEGG_Pathways
1,1,1-Trichloro-2,2-bis(4-chlorophenyl)ethane (DDT) degradation	Metabolism; Xenobiotics Biodegradation and Metabolism; 1,1,1-Trichloro-2,2-bis(4-chlorophenyl)ethane (DDT) degradation
ABC transporters	Environmental Information Processing; Membrane Transport; ABC transporters
Adherens junction	Cellular Processes; Cell Communication; Adherens junction
Adipocytokine signaling pathway	Organismal Systems; Endocrine System; Adipocytokine signaling pathway
African trypanosomiasis	Human Diseases; Infectious Diseases; African trypanosomiasis
Alanine, aspartate and glutamate metabolism	Metabolism; Amino Acid Metabolism; Alanine, aspartate and glutamate metabolism
Aldosterone-regulated sodium reabsorption	Organismal Systems; Excretory System; Aldosterone-regulated sodium reabsorption
Alzheimer's disease	Human Diseases; Neurodegenerative Diseases; Alzheimer's disease
Amino acid metabolism	Unclassified; Metabolism; Amino acid metabolism
Amino acid related enzymes	Metabolism; Amino Acid Metabolism; Amino acid related enzymes
Amino sugar and nucleotide sugar metabolism	Metabolism; Carbohydrate Metabolism; Amino sugar and nucleotide sugar metabolism
Aminoacyl-tRNA biosynthesis	Genetic Information Processing; Translation; Aminoacyl-tRNA biosynthesis
Aminobenzoate degradation	Metabolism; Xenobiotics Biodegradation and Metabolism; Aminobenzoate degradation
Amoebiasis	Human Diseases; Infectious Diseases; Amoebiasis
Amyotrophic lateral sclerosis (ALS)	Human Diseases; Neurodegenerative Diseases; Amyotrophic lateral sclerosis (ALS)
Antigen processing and presentation	Organismal Systems; Immune System; Antigen processing and presentation
Apoptosis	Cellular Processes; Cell Growth and Death; Apoptosis
Arachidonic acid metabolism	Metabolism; Lipid Metabolism; Arachidonic acid metabolism
Arginine and proline metabolism	Metabolism; Amino Acid Metabolism; Arginine and proline metabolism
Arrhythmogenic right ventricular cardiomyopathy (ARVC)	Human Diseases; Cardiovascular Diseases; Arrhythmogenic right ventricular cardiomyopathy (ARVC)
Ascorbate and aldarate metabolism	Metabolism; Carbohydrate Metabolism; Ascorbate and aldarate metabolism
Atrazine degradation	Metabolism; Xenobiotics Biodegradation and Metabolism; Atrazine degradation
Bacterial chemotaxis	Cellular Processes; Cell Motility; Bacterial chemotaxis
Bacterial invasion of epithelial cells	Human Diseases; Infectious Diseases; Bacterial invasion of epithelial cells
Bacterial motility proteins	Cellular Processes; Cell Motility; Bacterial motility proteins
Bacterial secretion system	Environmental Information Processing; Membrane Transport; Bacterial secretion system
Bacterial toxins	Environmental Information Processing; Signaling Molecules and Interaction; Bacterial toxins
Basal transcription factors	Genetic Information Processing; Transcription; Basal transcription factors
Base excision repair	Genetic Information Processing; Replication and Repair; Base excision repair
Benzoate degradation	Metabolism; Xenobiotics Biodegradation and Metabolism; Benzoate degradation
Betalain biosynthesis	Metabolism; Biosynthesis of Other Secondary Metabolites; Betalain biosynthesis
Bile secretion	Organismal Systems; Digestive System; Bile secretion
Biosynthesis and biodegradation of secondary metabolites	Unclassified; Metabolism; Biosynthesis and biodegradation of secondary metabolites
Biosynthesis of 12-, 14- and 16-membered macrolides	Metabolism; Metabolism of Terpenoids and Polyketides; Biosynthesis of 12-, 14- and 16-membered macrolides
Biosynthesis of ansamycins	Metabolism; Metabolism of Terpenoids and Polyketides; Biosynthesis of ansamycins
Biosynthesis of siderophore group nonribosomal peptides	Metabolism; Metabolism of Terpenoids and Polyketides; Biosynthesis of siderophore group nonribosomal peptides
Biosynthesis of type II polyketide backbone	Metabolism; Metabolism of Terpenoids and Polyketides; Biosynthesis of type II polyketide backbone
Biosynthesis of type II polyketide products	Metabolism; Metabolism of Terpenoids and Polyketides; Biosynthesis of type II polyketide products
Biosynthesis of unsaturated fatty acids	Metabolism; Lipid Metabolism; Biosynthesis of unsaturated fatty acids
Biosynthesis of vancomycin group antibiotics	Metabolism; Metabolism of Terpenoids and Polyketides; Biosynthesis of vancomycin group antibiotics
Biotin metabolism	Metabolism; Metabolism of Cofactors and Vitamins; Biotin metabolism
Bisphenol degradation	Metabolism; Xenobiotics Biodegradation and Metabolism; Bisphenol degradation
Bladder cancer	Human Diseases; Cancers; Bladder cancer
Butanoate metabolism	Metabolism; Carbohydrate Metabolism; Butanoate metabolism
Butirosin and neomycin biosynthesis	Metabolism; Biosynthesis of Other Secondary Metabolites; Butirosin and neomycin biosynthesis
C5-Branched dibasic acid metabolism	Metabolism; Carbohydrate Metabolism; C5-Branched dibasic acid metabolism
CAM ligands	Environmental Information Processing; Signaling Molecules and Interaction; CAM ligands
Caffeine metabolism	Metabolism; Biosynthesis of Other Secondary Metabolites; Caffeine metabolism
Calcium signaling pathway	Environmental Information Processing; Signal Transduction; Calcium signaling pathway
Caprolactam degradation	Metabolism; Xenobiotics Biodegradation and Metabolism; Caprolactam degradation
Carbohydrate digestion and absorption	Organismal Systems; Digestive System; Carbohydrate digestion and absorption
Carbohydrate metabolism	Unclassified; Metabolism; Carbohydrate metabolism
Carbon fixation in photosynthetic organisms	Metabolism; Energy Metabolism; Carbon fixation in photosynthetic organisms
Carbon fixation pathways in prokaryotes	Metabolism; Energy Metabolism; Carbon fixation pathways in prokaryotes
Cardiac muscle contraction	Organismal Systems; Circulatory System; Cardiac muscle contraction
Carotenoid biosynthesis	Metabolism; Metabolism of Terpenoids and Polyketides; Carotenoid biosynthesis
Cell cycle	Cellular Processes; Cell Growth and Death; Cell cycle
Cell cycle - Caulobacter	Cellular Processes; Cell Growth and Death; Cell cycle - Caulobacter
Cell cycle - yeast	Cellular Processes; Cell Growth and Death; Cell cycle - yeast
Cell division	Unclassified; Cellular Processes and Signaling; Cell division
Cell motility and secretion	Unclassified; Cellular Processes and Signaling; Cell motility and secretion
Cellular antigens	Environmental Information Processing; Signaling Molecules and Interaction; Cellular antigens
Chagas disease (American trypanosomiasis)	Human Diseases; Infectious Diseases; Chagas disease (American trypanosomiasis)
Chaperones and folding catalysts	Genetic Information Processing; Folding, Sorting and Degradation; Chaperones and folding catalysts
Chloroalkane and chloroalkene degradation	Metabolism; Xenobiotics Biodegradation and Metabolism; Chloroalkane and chloroalkene degradation
Chlorocyclohexane and chlorobenzene degradation	Metabolism; Xenobiotics Biodegradation and Metabolism; Chlorocyclohexane and chlorobenzene degradation
Cholinergic synapse	Organismal Systems; Nervous System; Cholinergic synapse
Chromosome	Genetic Information Processing; Replication and Repair; Chromosome
Chronic myeloid leukemia	Human Diseases; Cancers; Chronic myeloid leukemia
Circadian rhythm - plant	Organismal Systems; Environmental Adaptation; Circadian rhythm - plant
Citrate cycle (TCA cycle)	Metabolism; Carbohydrate Metabolism; Citrate cycle (TCA cycle)
Clavulanic acid biosynthesis	Metabolism; Biosynthesis of Other Secondary Metabolites; Clavulanic acid biosynthesis
Colorectal cancer	Human Diseases; Cancers; Colorectal cancer
Complement and coagulation cascades	Organismal Systems; Immune System; Complement and coagulation cascades
Cyanoamino acid metabolism	Metabolism; Metabolism of Other Amino Acids; Cyanoamino acid metabolism
Cysteine and methionine metabolism	Metabolism; Amino Acid Metabolism; Cysteine and methionine metabolism
Cytochrome P450	Metabolism; Enzyme Families; Cytochrome P450
Cytokine receptors	Environmental Information Processing; Signaling Molecules and Interaction; Cytokine receptors
Cytokine-cytokine receptor interaction	Environmental Information Processing; Signaling Molecules and Interaction; Cytokine-cytokine receptor interaction
Cytoskeleton proteins	Cellular Processes; Cell Motility; Cytoskeleton proteins
Cytosolic DNA-sensing pathway	Organismal Systems; Immune System; Cytosolic DNA-sensing pathway
D-Alanine metabolism	Metabolism; Metabolism of Other Amino Acids; D-Alanine metabolism
D-Arginine and D-ornithine metabolism	Metabolism; Metabolism of Other Amino Acids; D-Arginine and D-ornithine metabolism
D-Glutamine and D-glutamate metabolism	Metabolism; Metabolism of Other Amino Acids; D-Glutamine and D-glutamate metabolism
DNA repair and recombination proteins	Genetic Information Processing; Replication and Repair; DNA repair and recombination proteins
DNA replication	Genetic Information Processing; Replication and Repair; DNA replication
DNA replication proteins	Genetic Information Processing; Replication and Repair; DNA replication proteins
Dilated cardiomyopathy (DCM)	Human Diseases; Cardiovascular Diseases; Dilated cardiomyopathy (DCM)
Dioxin degradation	Metabolism; Xenobiotics Biodegradation and Metabolism; Dioxin degradation
Drug metabolism - cytochrome P450	Metabolism; Xenobiotics Biodegradation and Metabolism; Drug metabolism - cytochrome P450
Drug metabolism - other enzymes	Metabolism; Xenobiotics Biodegradation and Metabolism; Drug metabolism - other enzymes
ECM-receptor interaction	Environmental Information Processing; Signaling Molecules and Interaction; ECM-receptor interaction
Electron transfer carriers	Unclassified; Cellular Processes and Signaling; Electron transfer carriers
Endocrine and other factor-regulated calcium reabsorption	Organismal Systems; Excretory System; Endocrine and other factor-regulated calcium reabsorption
Endocytosis	Cellular Processes; Transport and Catabolism; Endocytosis
Energy metabolism	Unclassified; Metabolism; Energy metabolism
Epithelial cell signaling in Helicobacter pylori infection	Human Diseases; Infectious Diseases; Epithelial cell signaling in Helicobacter pylori infection
ErbB signaling pathway	Environmental Information Processing; Signal Transduction; ErbB signaling pathway
Ether lipid metabolism	Metabolism; Lipid Metabolism; Ether lipid metabolism
Ethylbenzene degradation	Metabolism; Xenobiotics Biodegradation and Metabolism; Ethylbenzene degradation
Fat digestion and absorption	Organismal Systems; Digestive System; Fat digestion and absorption
Fatty acid biosynthesis	Metabolism; Lipid Metabolism; Fatty acid biosynthesis
Fatty acid elongation in mitochondria	Metabolism; Lipid Metabolism; Fatty acid elongation in mitochondria
Fatty acid metabolism	Metabolism; Lipid Metabolism; Fatty acid metabolism
Fc epsilon RI signaling pathway	Organismal Systems; Immune System; Fc epsilon RI signaling pathway
Fc gamma R-mediated phagocytosis	Organismal Systems; Immune System; Fc gamma R-mediated phagocytosis
Flagellar assembly	Cellular Processes; Cell Motility; Flagellar assembly
Flavone and flavonol biosynthesis	Metabolism; Biosynthesis of Other Secondary Metabolites; Flavone and flavonol biosynthesis
Flavonoid biosynthesis	Metabolism; Biosynthesis of Other Secondary Metabolites; Flavonoid biosynthesis
Fluorobenzoate degradation	Metabolism; Xenobiotics Biodegradation and Metabolism; Fluorobenzoate degradation
Focal adhesion	Cellular Processes; Cell Communication; Focal adhesion
Folate biosynthesis	Metabolism; Metabolism of Cofactors and Vitamins; Folate biosynthesis
Fructose and mannose metabolism	Metabolism; Carbohydrate Metabolism; Fructose and mannose metabolism
Function unknown	Unclassified; Poorly Characterized; Function unknown
G protein-coupled receptors	Environmental Information Processing; Signaling Molecules and Interaction; G protein-coupled receptors
GTP-binding proteins	Environmental Information Processing; Signaling Molecules and Interaction; GTP-binding proteins
Galactose metabolism	Metabolism; Carbohydrate Metabolism; Galactose metabolism
Gastric acid secretion	Organismal Systems; Digestive System; Gastric acid secretion
General function prediction only	Unclassified; Poorly Characterized; General function prediction only
Geraniol degradation	Metabolism; Metabolism of Terpenoids and Polyketides; Geraniol degradation
Germination	Unclassified; Cellular Processes and Signaling; Germination
Glioma	Human Diseases; Cancers; Glioma
Glutamatergic synapse	Organismal Systems; Nervous System; Glutamatergic synapse
Glutathione metabolism	Metabolism; Metabolism of Other Amino Acids; Glutathione metabolism
Glycan bindng proteins	Environmental Information Processing; Signaling Molecules and Interaction; Glycan bindng proteins
Glycan biosynthesis and metabolism	Unclassified; Metabolism; Glycan biosynthesis and metabolism
Glycerolipid metabolism	Metabolism; Lipid Metabolism; Glycerolipid metabolism
Glycerophospholipid metabolism	Metabolism; Lipid Metabolism; Glycerophospholipid metabolism
Glycine, serine and threonine metabolism	Metabolism; Amino Acid Metabolism; Glycine, serine and threonine metabolism
Glycolysis / Gluconeogenesis	Metabolism; Carbohydrate Metabolism; Glycolysis / Gluconeogenesis
Glycosaminoglycan biosynthesis - chondroitin sulfate	Metabolism; Glycan Biosynthesis and Metabolism; Glycosaminoglycan biosynthesis - chondroitin sulfate
Glycosaminoglycan degradation	Metabolism; Glycan Biosynthesis and Metabolism; Glycosaminoglycan degradation
Glycosphingolipid biosynthesis - ganglio series	Metabolism; Glycan Biosynthesis and Metabolism; Glycosphingolipid biosynthesis - ganglio series
Glycosphingolipid biosynthesis - globo series	Metabolism; Glycan Biosynthesis and Metabolism; Glycosphingolipid biosynthesis - globo series
Glycosphingolipid biosynthesis - lacto and neolacto series	Metabolism; Glycan Biosynthesis and Metabolism; Glycosphingolipid biosynthesis - lacto and neolacto series
Glycosylphosphatidylinositol(GPI)-anchor biosynthesis	Metabolism; Glycan Biosynthesis and Metabolism; Glycosylphosphatidylinositol(GPI)-anchor biosynthesis
Glycosyltransferases	Metabolism; Glycan Biosynthesis and Metabolism; Glycosyltransferases
Glyoxylate and dicarboxylate metabolism	Metabolism; Carbohydrate Metabolism; Glyoxylate and dicarboxylate metabolism
GnRH signaling pathway	Organismal Systems; Endocrine System; GnRH signaling pathway
Hedgehog signaling pathway	Environmental Information Processing; Signal Transduction; Hedgehog signaling pathway
Hematopoietic cell lineage	Organismal Systems; Immune System; Hematopoietic cell lineage
Hepatitis C	Human Diseases; Infectious Diseases; Hepatitis C
Histidine metabolism	Metabolism; Amino Acid Metabolism; Histidine metabolism
Homologous recombination	Genetic Information Processing; Replication and Repair; Homologous recombination
Huntington's disease	Human Diseases; Neurodegenerative Diseases; Huntington's disease
Hypertrophic cardiomyopathy (HCM)	Human Diseases; Cardiovascular Diseases; Hypertrophic cardiomyopathy (HCM)
Indole alkaloid biosynthesis	Metabolism; Biosynthesis of Other Secondary Metabolites; Indole alkaloid biosynthesis
Influenza A	Human Diseases; Infectious Diseases; Influenza A
Inorganic ion transport and metabolism	Unclassified; Cellular Processes and Signaling; Inorganic ion transport and metabolism
Inositol phosphate metabolism	Metabolism; Carbohydrate Metabolism; Inositol phosphate metabolism
Insulin signaling pathway	Organismal Systems; Endocrine System; Insulin signaling pathway
Ion channels	Environmental Information Processing; Signaling Molecules and Interaction; Ion channels
Isoflavonoid biosynthesis	Metabolism; Biosynthesis of Other Secondary Metabolites; Isoflavonoid biosynthesis
Isoquinoline alkaloid biosynthesis	Metabolism; Biosynthesis of Other Secondary Metabolites; Isoquinoline alkaloid biosynthesis
Leishmaniasis	Human Diseases; Infectious Diseases; Leishmaniasis
Leukocyte transendothelial migration	Organismal Systems; Immune System; Leukocyte transendothelial migration
Limonene and pinene degradation	Metabolism; Metabolism of Terpenoids and Polyketides; Limonene and pinene degradation
Linoleic acid metabolism	Metabolism; Lipid Metabolism; Linoleic acid metabolism
Lipid biosynthesis proteins	Metabolism; Lipid Metabolism; Lipid biosynthesis proteins
Lipid metabolism	Unclassified; Metabolism; Lipid metabolism
Lipoic acid metabolism	Metabolism; Metabolism of Cofactors and Vitamins; Lipoic acid metabolism
Lipopolysaccharide biosynthesis	Metabolism; Glycan Biosynthesis and Metabolism; Lipopolysaccharide biosynthesis
Lipopolysaccharide biosynthesis proteins	Metabolism; Glycan Biosynthesis and Metabolism; Lipopolysaccharide biosynthesis proteins
Long-term depression	Organismal Systems; Nervous System; Long-term depression
Long-term potentiation	Organismal Systems; Nervous System; Long-term potentiation
Lysine biosynthesis	Metabolism; Amino Acid Metabolism; Lysine biosynthesis
Lysine degradation	Metabolism; Amino Acid Metabolism; Lysine degradation
Lysosome	Cellular Processes; Transport and Catabolism; Lysosome
MAPK signaling pathway	Environmental Information Processing; Signal Transduction; MAPK signaling pathway
MAPK signaling pathway - yeast	Environmental Information Processing; Signal Transduction; MAPK signaling pathway - yeast
Measles	Human Diseases; Infectious Diseases; Measles
Meiosis - yeast	Cellular Processes; Cell Growth and Death; Meiosis - yeast
Melanogenesis	Organismal Systems; Endocrine System; Melanogenesis
Membrane and intracellular structural molecules	Unclassified; Cellular Processes and Signaling; Membrane and intracellular structural molecules
Metabolism of cofactors and vitamins	Unclassified; Metabolism; Metabolism of cofactors and vitamins
Metabolism of xenobiotics by cytochrome P450	Metabolism; Xenobiotics Biodegradation and Metabolism; Metabolism of xenobiotics by cytochrome P450
Methane metabolism	Metabolism; Energy Metabolism; Methane metabolism
Mineral absorption	Organismal Systems; Digestive System; Mineral absorption
Mismatch repair	Genetic Information Processing; Replication and Repair; Mismatch repair
N-Glycan biosynthesis	Metabolism; Glycan Biosynthesis and Metabolism; N-Glycan biosynthesis
NOD-like receptor signaling pathway	Organismal Systems; Immune System; NOD-like receptor signaling pathway
Naphthalene degradation	Metabolism; Xenobiotics Biodegradation and Metabolism; Naphthalene degradation
Neuroactive ligand-receptor interaction	Environmental Information Processing; Signaling Molecules and Interaction; Neuroactive ligand-receptor interaction
Neurotrophin signaling pathway	Organismal Systems; Nervous System; Neurotrophin signaling pathway
Nicotinate and nicotinamide metabolism	Metabolism; Metabolism of Cofactors and Vitamins; Nicotinate and nicotinamide metabolism
Nitrogen metabolism	Metabolism; Energy Metabolism; Nitrogen metabolism
Nitrotoluene degradation	Metabolism; Xenobiotics Biodegradation and Metabolism; Nitrotoluene degradation
Non-homologous end-joining	Genetic Information Processing; Replication and Repair; Non-homologous end-joining
Notch signaling pathway	Environmental Information Processing; Signal Transduction; Notch signaling pathway
Novobiocin biosynthesis	Metabolism; Biosynthesis of Other Secondary Metabolites; Novobiocin biosynthesis
Nucleotide excision repair	Genetic Information Processing; Replication and Repair; Nucleotide excision repair
Nucleotide metabolism	Unclassified; Metabolism; Nucleotide metabolism
Olfactory transduction	Organismal Systems; Sensory System; Olfactory transduction
One carbon pool by folate	Metabolism; Metabolism of Cofactors and Vitamins; One carbon pool by folate
Oocyte meiosis	Cellular Processes; Cell Growth and Death; Oocyte meiosis
Other glycan degradation	Metabolism; Glycan Biosynthesis and Metabolism; Other glycan degradation
Other ion-coupled transporters	Unclassified; Cellular Processes and Signaling; Other ion-coupled transporters
Other transporters	Unclassified; Cellular Processes and Signaling; Other transporters
Other types of O-glycan biosynthesis	Metabolism; Glycan Biosynthesis and Metabolism; Other types of O-glycan biosynthesis
Others	Unclassified; Metabolism; Others
Oxidative phosphorylation	Metabolism; Energy Metabolism; Oxidative phosphorylation
PPAR signaling pathway	Organismal Systems; Endocrine System; PPAR signaling pathway
Pancreatic cancer	Human Diseases; Cancers; Pancreatic cancer
Pancreatic secretion	Organismal Systems; Digestive System; Pancreatic secretion
Pantothenate and CoA biosynthesis	Metabolism; Metabolism of Cofactors and Vitamins; Pantothenate and CoA biosynthesis
Parkinson's disease	Human Diseases; Neurodegenerative Diseases; Parkinson's disease
Pathogenic Escherichia coli infection	Human Diseases; Infectious Diseases; Pathogenic Escherichia coli infection
Pathways in cancer	Human Diseases; Cancers; Pathways in cancer
Penicillin and cephalosporin biosynthesis	Metabolism; Biosynthesis of Other Secondary Metabolites; Penicillin and cephalosporin biosynthesis
Pentose and glucuronate interconversions	Metabolism; Carbohydrate Metabolism; Pentose and glucuronate interconversions
Pentose phosphate pathway	Metabolism; Carbohydrate Metabolism; Pentose phosphate pathway
Peptidases	Metabolism; Enzyme Families; Peptidases
Peptidoglycan biosynthesis	Metabolism; Glycan Biosynthesis and Metabolism; Peptidoglycan biosynthesis
Peroxisome	Cellular Processes; Transport and Catabolism; Peroxisome
Pertussis	Human Diseases; Infectious Diseases; Pertussis
Phagosome	Cellular Processes; Transport and Catabolism; Phagosome
Phenylalanine metabolism	Metabolism; Amino Acid Metabolism; Phenylalanine metabolism
Phenylalanine, tyrosine and tryptophan biosynthesis	Metabolism; Amino Acid Metabolism; Phenylalanine, tyrosine and tryptophan biosynthesis
Phenylpropanoid biosynthesis	Metabolism; Biosynthesis of Other Secondary Metabolites; Phenylpropanoid biosynthesis
Phosphatidylinositol signaling system	Environmental Information Processing; Signal Transduction; Phosphatidylinositol signaling system
Phosphonate and phosphinate metabolism	Metabolism; Metabolism of Other Amino Acids; Phosphonate and phosphinate metabolism
Phosphotransferase system (PTS)	Environmental Information Processing; Membrane Transport; Phosphotransferase system (PTS)
Photosynthesis	Metabolism; Energy Metabolism; Photosynthesis
Photosynthesis - antenna proteins	Metabolism; Energy Metabolism; Photosynthesis - antenna proteins
Photosynthesis proteins	Metabolism; Energy Metabolism; Photosynthesis proteins
Phototransduction	Organismal Systems; Sensory System; Phototransduction
Phototransduction - fly	Organismal Systems; Sensory System; Phototransduction - fly
Plant-pathogen interaction	Organismal Systems; Environmental Adaptation; Plant-pathogen interaction
Polycyclic aromatic hydrocarbon degradation	Metabolism; Xenobiotics Biodegradation and Metabolism; Polycyclic aromatic hydrocarbon degradation
Polyketide sugar unit biosynthesis	Metabolism; Metabolism of Terpenoids and Polyketides; Polyketide sugar unit biosynthesis
Pores ion channels	Unclassified; Cellular Processes and Signaling; Pores ion channels
Porphyrin and chlorophyll metabolism	Metabolism; Metabolism of Cofactors and Vitamins; Porphyrin and chlorophyll metabolism
Prenyltransferases	Metabolism; Metabolism of Terpenoids and Polyketides; Prenyltransferases
Primary bile acid biosynthesis	Metabolism; Lipid Metabolism; Primary bile acid biosynthesis
Primary immunodeficiency	Human Diseases; Immune System Diseases; Primary immunodeficiency
Prion diseases	Human Diseases; Neurodegenerative Diseases; Prion diseases
Progesterone-mediated oocyte maturation	Organismal Systems; Endocrine System; Progesterone-mediated oocyte maturation
Propanoate metabolism	Metabolism; Carbohydrate Metabolism; Propanoate metabolism
Prostate cancer	Human Diseases; Cancers; Prostate cancer
Proteasome	Genetic Information Processing; Folding, Sorting and Degradation; Proteasome
Protein digestion and absorption	Organismal Systems; Digestive System; Protein digestion and absorption
Protein export	Genetic Information Processing; Folding, Sorting and Degradation; Protein export
Protein folding and associated processing	Unclassified; Genetic Information Processing; Protein folding and associated processing
Protein kinases	Metabolism; Enzyme Families; Protein kinases
Protein processing in endoplasmic reticulum	Genetic Information Processing; Folding, Sorting and Degradation; Protein processing in endoplasmic reticulum
Proximal tubule bicarbonate reclamation	Organismal Systems; Excretory System; Proximal tubule bicarbonate reclamation
Purine metabolism	Metabolism; Nucleotide Metabolism; Purine metabolism
Pyrimidine metabolism	Metabolism; Nucleotide Metabolism; Pyrimidine metabolism
Pyruvate metabolism	Metabolism; Carbohydrate Metabolism; Pyruvate metabolism
RIG-I-like receptor signaling pathway	Organismal Systems; Immune System; RIG-I-like receptor signaling pathway
RNA degradation	Genetic Information Processing; Folding, Sorting and Degradation; RNA degradation
RNA polymerase	Genetic Information Processing; Transcription; RNA polymerase
RNA transport	Genetic Information Processing; Translation; RNA transport
Regulation of actin cytoskeleton	Cellular Processes; Cell Motility; Regulation of actin cytoskeleton
Renal cell carcinoma	Human Diseases; Cancers; Renal cell carcinoma
Renin-angiotensin system	Organismal Systems; Endocrine System; Renin-angiotensin system
Replication, recombination and repair proteins	Unclassified; Genetic Information Processing; Replication, recombination and repair proteins
Restriction enzyme	Unclassified; Genetic Information Processing; Restriction enzyme
Retinol metabolism	Metabolism; Metabolism of Cofactors and Vitamins; Retinol metabolism
Rheumatoid arthritis	Human Diseases; Immune System Diseases; Rheumatoid arthritis
Riboflavin metabolism	Metabolism; Metabolism of Cofactors and Vitamins; Riboflavin metabolism
Ribosome	Genetic Information Processing; Translation; Ribosome
Ribosome Biogenesis	Genetic Information Processing; Translation; Ribosome Biogenesis
Ribosome biogenesis in eukaryotes	Genetic Information Processing; Translation; Ribosome biogenesis in eukaryotes
Salivary secretion	Organismal Systems; Digestive System; Salivary secretion
Secondary bile acid biosynthesis	Metabolism; Lipid Metabolism; Secondary bile acid biosynthesis
Secretion system	Environmental Information Processing; Membrane Transport; Secretion system
Selenocompound metabolism	Metabolism; Metabolism of Other Amino Acids; Selenocompound metabolism
Sesquiterpenoid biosynthesis	Metabolism; Metabolism of Terpenoids and Polyketides; Sesquiterpenoid biosynthesis
Shigellosis	Human Diseases; Infectious Diseases; Shigellosis
Signal transduction mechanisms	Unclassified; Cellular Processes and Signaling; Signal transduction mechanisms
Small cell lung cancer	Human Diseases; Cancers; Small cell lung cancer
Sphingolipid metabolism	Metabolism; Lipid Metabolism; Sphingolipid metabolism
Spliceosome	Genetic Information Processing; Transcription; Spliceosome
Sporulation	Unclassified; Cellular Processes and Signaling; Sporulation
Staphylococcus aureus infection	Human Diseases; Infectious Diseases; Staphylococcus aureus infection
Starch and sucrose metabolism	Metabolism; Carbohydrate Metabolism; Starch and sucrose metabolism
Steroid biosynthesis	Metabolism; Lipid Metabolism; Steroid biosynthesis
Steroid hormone biosynthesis	Metabolism; Lipid Metabolism; Steroid hormone biosynthesis
Stilbenoid, diarylheptanoid and gingerol biosynthesis	Metabolism; Biosynthesis of Other Secondary Metabolites; Stilbenoid, diarylheptanoid and gingerol biosynthesis
Streptomycin biosynthesis	Metabolism; Biosynthesis of Other Secondary Metabolites; Streptomycin biosynthesis
Styrene degradation	Metabolism; Xenobiotics Biodegradation and Metabolism; Styrene degradation
Sulfur metabolism	Metabolism; Energy Metabolism; Sulfur metabolism
Sulfur relay system	Genetic Information Processing; Folding, Sorting and Degradation; Sulfur relay system
Synthesis and degradation of ketone bodies	Metabolism; Lipid Metabolism; Synthesis and degradation of ketone bodies
Systemic lupus erythematosus	Human Diseases; Immune System Diseases; Systemic lupus erythematosus
TGF-beta signaling pathway	Environmental Information Processing; Signal Transduction; TGF-beta signaling pathway
Taurine and hypotaurine metabolism	Metabolism; Metabolism of Other Amino Acids; Taurine and hypotaurine metabolism
Terpenoid backbone biosynthesis	Metabolism; Metabolism of Terpenoids and Polyketides; Terpenoid backbone biosynthesis
Tetracycline biosynthesis	Metabolism; Metabolism of Terpenoids and Polyketides; Tetracycline biosynthesis
Thiamine metabolism	Metabolism; Metabolism of Cofactors and Vitamins; Thiamine metabolism
Tight junction	Cellular Processes; Cell Communication; Tight junction
Toluene degradation	Metabolism; Xenobiotics Biodegradation and Metabolism; Toluene degradation
Toxoplasmosis	Human Diseases; Infectious Diseases; Toxoplasmosis
Transcription factors	Genetic Information Processing; Transcription; Transcription factors
Transcription machinery	Genetic Information Processing; Transcription; Transcription machinery
Transcription related proteins	Unclassified; Genetic Information Processing; Transcription related proteins
Translation factors	Genetic Information Processing; Translation; Translation factors
Translation proteins	Unclassified; Genetic Information Processing; Translation proteins
Transporters	Environmental Information Processing; Membrane Transport; Transporters
Tropane, piperidine and pyridine alkaloid biosynthesis	Metabolism; Biosynthesis of Other Secondary Metabolites; Tropane, piperidine and pyridine alkaloid biosynthesis
Tryptophan metabolism	Metabolism; Amino Acid Metabolism; Tryptophan metabolism
Tuberculosis	Human Diseases; Infectious Diseases; Tuberculosis
Two-component system	Environmental Information Processing; Signal Transduction; Two-component system
Type I diabetes mellitus	Human Diseases; Metabolic Diseases; Type I diabetes mellitus
Type II diabetes mellitus	Human Diseases; Metabolic Diseases; Type II diabetes mellitus
Tyrosine metabolism	Metabolism; Amino Acid Metabolism; Tyrosine metabolism
Ubiquinone and other terpenoid-quinone biosynthesis	Metabolism; Metabolism of Cofactors and Vitamins; Ubiquinone and other terpenoid-quinone biosynthesis
Ubiquitin system	Genetic Information Processing; Folding, Sorting and Degradation; Ubiquitin system
VEGF signaling pathway	Environmental Information Processing; Signal Transduction; VEGF signaling pathway
Valine, leucine and isoleucine biosynthesis	Metabolism; Amino Acid Metabolism; Valine, leucine and isoleucine biosynthesis
Valine, leucine and isoleucine degradation	Metabolism; Amino Acid Metabolism; Valine, leucine and isoleucine degradation
Various types of N-glycan biosynthesis	Metabolism; Glycan Biosynthesis and Metabolism; Various types of N-glycan biosynthesis
Vascular smooth muscle contraction	Organismal Systems; Circulatory System; Vascular smooth muscle contraction
Vasopressin-regulated water reabsorption	Organismal Systems; Excretory System; Vasopressin-regulated water reabsorption
Vibrio cholerae infection	Human Diseases; Infectious Diseases; Vibrio cholerae infection
Vibrio cholerae pathogenic cycle	Human Diseases; Infectious Diseases; Vibrio cholerae pathogenic cycle
Viral myocarditis	Human Diseases; Cardiovascular Diseases; Viral myocarditis
Vitamin B6 metabolism	Metabolism; Metabolism of Cofactors and Vitamins; Vitamin B6 metabolism
Wnt signaling pathway	Environmental Information Processing; Signal Transduction; Wnt signaling pathway
Xylene degradation	Metabolism; Xenobiotics Biodegradation and Metabolism; Xylene degradation
Zeatin biosynthesis	Metabolism; Metabolism of Terpenoids and Polyketides; Zeatin biosynthesis
alpha-Linolenic acid metabolism	Metabolism; Lipid Metabolism; alpha-Linolenic acid metabolism
beta-Alanine metabolism	Metabolism; Metabolism of Other Amino Acids; beta-Alanine metabolism
beta-Lactam resistance	Metabolism; Biosynthesis of Other Secondary Metabolites; beta-Lactam resistance
mRNA surveillance pathway	Genetic Information Processing; Translation; mRNA surveillance pathway
mTOR signaling pathway	Environmental Information Processing; Signal Transduction; mTOR signaling pathway
p53 signaling pathway	Cellular Processes; Cell Growth and Death; p53 signaling pathway
